3141112412
1      1 1
2   1    4
4   3    1
1      121
2112     1
1        1
4  1    11
2  2     1
1552314211